1111111111111
1P00001000C01
1000111011101
1C00000000001
1110111011101
1C000000000C1
1011111011101
1000C00000001
1C0000C0000E1
1111111111111