1111111111111111111111111
1P000000000111000000000E1
111111110001110000C000001
1000000000000100000000001
1011110111110111111111101
1010000000010000000000101
1010111111011111111010101
10001C0000000000010010001
1110111111111111011111111
1C000000000000000000000C1
1111111111111111111111111